W0000000\n
W++0R00\n
WTT00R00\n
00000+$0\n
B0000T00\n
000T+000\n
0000#0j0\n
00000?00\n