00000000\n
00000000\n
00000000\n
00000+00\n
00000TW0\n
00#00000\n
00000R00\n
00000000\n