00000000\n
0000?000\n
000000R0\n
00#00000\n
00000T+0\n
000T0000\n
R00+0000\n
00000000\n