00000000\n
00000000\n
00000000\n
00000$00\n
$000#00$\n
000$00#0\n
00000000\n
00000000\n