00000000\n
00000000\n
0#000000\n
00000000\n
000$0000\n
000$0000\n
00000#00\n
00000000\n