00000000\n
00+W+00M\n
0$0000jM\n
000W000+\n
M0$W+000\n
M0000#00\n
0$00000?\n
0000+M+0\n