00$00000\n
0000$000\n
0+0?00+0\n
$00000W0\n
0000%0W+\n
00+00#W0\n
00WWj0$0\n
+0000+00\n