WWW00000\n
?000$000\n
0+0000+0\n
$0000000\n
00+0%000\n
00000000\n
#00000$0\n
0000#000\n