00000000\n
00000000\n
0000?000\n
000+0+00\n
000+$+00\n
000+0%00\n
0000#000\n
00000000\n