00000000\n
00000000\n
00000000\n
00000000\n
0000#0$0\n
00000$00\n
0000$0$0\n
00000000\n