000000WW\n
0$0000++\n
000$0$00\n
0#000000\n
000?j%00\n
++00000+\n
0000000+\n
000+WWW0\n