00000000\n
00000+00\n
00+00000\n
000j00$+\n
0?000000\n
0000+000\n
00000000\n
00000000\n