00000000\n
000W0+00\n
00+000W0\n
000j00$+\n
0?000W00\n
0000+000\n
00000000\n
00000000\n